small	작은
country	나라
stupid	바보
strong	강한
study	공부하다
city	도시
book	책
happy	행복한
weak	약한
apple	사과
computer	컴퓨터
music	음악
school	학교
cat	고양이
sad	슬픈
dark	어두운
friend	친구
table	테이블
banana	바나나
large	큰
chair	의자
water	물
home	집
fast	빠른
slow	느린
phone	전화기
family	가족
dog	개
