explain	설명하다
symbol	상징/ 징표
castle	성
regional	지역적인
in the first place	처음으로
universally	보편적으로/ 일반적으로
training	훈련
explanation	설명
at first	처음에는
considerable	상당한
reinforce	강화시키다
statement	진술
suppression	저하/ 의기소침
consider	고려하다/ 간주하다
female	여성의
frankly speaking	솔직히 말하여
press	누르다/ 언론/ 출판
enlighten	계몽시키다 개화시키다
in the place of	～대신에
ss	s
law	법
last	마지막/ 지난 계속하다
recently	최근에
invent	발명하다/ 만들다
lately	최근에
suppress	저하시키다
illegal	불법적인
intelligent	지적인
oppression	억압
region	지역
invention	발명
